海洋自主号=海洋自主号
海洋自由号=海洋自由号
海洋独立号=海洋独立号
海洋绿洲号=海洋绿洲号
海洋魅力号=海洋魅力号
海洋神话号=海洋神话号
海洋荣光号=海洋荣光号
海洋富丽号=海洋富丽号
海洋迎风号=海洋迎风号
海洋幻丽号=海洋幻丽号
海洋梦幻号=海洋梦幻号
海洋航行者号=海洋航行者号
海洋探险者号=海洋探险者号
海洋冒险者号=海洋冒险者号
海洋领航者号=海洋领航者号
海洋水手号=海洋水手号
海洋灿烂号=海洋灿烂号
海洋光辉号=海洋光辉号
海洋旋律号=海洋旋律号
海洋珠宝号=海洋珠宝号
海洋君主号=海洋君主号
海皇号=海皇号
海洋帝王号=海洋帝王号
爱兰歌娜号=爱兰歌娜号
 幸运号=幸运号
协和号=协和号
经典号=经典号
炫目号=炫目号
大西洋号=大西洋号
欧洲号=欧洲号
命运女神号=命运女神号
海洋号=海洋号
地中海号=地中海号
浪漫号=浪漫号
罗曼蒂克号=浪漫号
塞琳娜号=塞琳娜号
维多利亚号=维多利亚号
太平洋号=太平洋号
诗歌号=诗歌号
管乐号=管乐号
音乐号=音乐号
歌剧号=歌剧号
抒情号=抒情号
序曲号=序曲号
和睦号=和睦号
双鱼星号=双鱼星号
宝瓶星号=宝瓶星号
处女星号=处女星号
双子星号=双子星号
天秤星号=天秤星号
蓝宝石公主号=蓝宝石公主号
加勒比公主号=加勒比公主号
珊瑚公主号=珊瑚公主号
皇冠公主号=皇冠公主号
黎明公主号=黎明公主号
钻石公主号=钻石公主号
黄金公主号=黄金公主号
至尊公主号=至尊公主号
海岛公主号=海岛公主号
太平洋公主号=太平洋公主号
翡翠公主号=翡翠公主号
红宝石公主号=红宝石公主号
大溪地公主号=大溪地公主号
皇家公主号=皇家公主号
太阳公主号=太阳公主号
碧海公主号=碧海公主号
星辰公主号=星辰公主号
银云号=银云号
银风号 =银风号
银影号=银影号
银啸号=银啸号
银神号=银神号
阿尔贝二世亲王=阿尔贝二世亲王
威士特丹号=威士特丹号
鹿特丹号=鹿特丹号
如德丹号=如德丹号
普林盛丹号=普林盛丹号
尚丹号=尚丹号
诺丹号=诺丹号
华伦丹号=华伦丹号
新阿姆斯特丹号=新阿姆斯特丹号
维丹号=维丹号
马士丹号=马士丹号
史特丹号=史特丹号
欧罗丹号=欧罗丹号
雷丹号=雷丹号
阿姆斯特丹号=阿姆斯特丹号
奥斯特丹号=奥斯特丹号
挪威之星号=挪威之星号
挪威天空号=挪威天空号
挪威太阳号=挪威太阳号
挪威宝石号=挪威宝石号
挪威明珠号=挪威明珠号
挪威珠宝号=挪威珠宝号
挪威精神号=挪威精神号
挪威翡翠号=挪威翡翠号
美国之傲号=美国之傲号
挪威之玉号=挪威之玉号
挪威珍珠号=挪威珍珠号
挪威史诗号=挪威史诗号















